wwwwwwwwwwwww
w...........w
w....2w2....w
w.....w.....w
w3...gw+...3w
w.....w.....w
w....2w2....w
wA..........w
wwwwwwwwwwwww
