wwwwwwwwwwwww
w..3...w...1w
w.2+3..w....w
w..2...w....w
w...........w
w....w.....Aw
wwwwww..wwwww
wg.........3w
wwwwwwwwwwwww