wwwwwwwwwwwww
w3......2...w
w...........w
w.www..w.wwww
w.w+w..w..www
w...w..w1...w
wwwww..wwww.w
wg.........Aw
wwwwwwwwwwwww
