wwwwwwwwwwwww
w+..1..3....w
w.2.........w
w2..2....1..w
w.....g.3...w
w..3..3.....w
w....2...3..w
w....2.....Aw
wwwwwwwwwwwww
