wwwwwwwwwwww
we.w..A..wbw
w..w.....wxw
w31w.....w~w
w..........w
w..........w
w.d.....d..w
w..........w
wwww.......w
wr.~.....i.w
wwwwwwwwwwww