wwwwwwwwwwww
wiw......wfw
w1w.d..d.w1w
w~........~w
w...wwww...w
w..wwwwww..w
w..........w
w....~.....w
w....x.....w
wr.~xex~..Aw
wwwwwwwwwwww