wwwwwwwwwwww
w.....f....w
w1wwwwwwww1w
wxxxxxxxxxxw
w.d.......Aw
w~~........w
wr~........w
w~~.......iw
w~~~~~~~~~~w
w~~~~~e~~~~w
wwwwwwwwwwww