wwwwwwwwwwww
w...wew...yw
w...w1w....w
w..........w
w..........w
wwww~~~~wwww
wwww~~~~wwww
w..........w
www..dd....w
wr4.....A..w
wwwwwwwwwwww