wwwwwwwwwww
w...w.....w
w.w...ww.Aw
w.........w
wwwww.....w
ww........w
ww..w..w..w
ww..w..w..w
wwwwwwwwwww