wwwwwwwwwwwwwwwwwwwwwwwwwwww
w0.............0.........0.w
w...w.0.....0...wwww.A.w...w
w..0w....0.....ww.0.wwww...w
w...w.........ww.......w..0w
w...w...0..ww..0.....0.w...w
w0..w......w.....1.....w...w
w...w.....0............w...w
w...www.wwwwwww..wwwww.ww..w
w1....0....0........1......w
wwwwwwwwwwwwwwwwwwwwwwwwwwww