wwwwwwwwwwwwwwwwwwwwwwwwwwww
w0.0www1........0......w.0.w
w..ww.www.............1w...w
w...0.......0.....wwwwww...w
w.................0........w
w.........wwwwwww..........w
w...0.....ww.A.w...0....0..w
w.........w..wwww0wwwww....w
w.0.......w..w.............w
w.....0..........0......0..w
wwwwwwwwwwwwwwwwwwwwwwwwwwww