wwwwwwwwwwwwwwwwwwwwwwwwwwww
w..........0...........0..0w
w..A...w...................w
w.......w.....0.....0......w
w...0...w.w...w...w....w...w
w.......w...0......1.......w
w......w...................w
w...0......0......w..w..w..w
w.............0...w..w..w..w
w1..0...0.........w.0w.0w.0w
wwwwwwwwwwwwwwwwwwwwwwwwwwww