wwwwwwwwwwwwwwwwwwwwwwwwwwww
w..................w.0..0..w
w...0....0...1.....w.......w
w..................w....0..w
w....w.w..w..w..w..w..0....w
w..0.w.....................w
w....w...0.....1.....0.....w
w..................0.....A.w
w......wwwwww...0..w.......w
w..1....0....0.....0....0..w
wwwwwwwwwwwwwwwwwwwwwwwwwwww