wwwwwwwwwwwww
www.0...wwwww
www.....w..Aw
w...w.1.....w
w..1.w......w
w.0w..w.....w
w.....1.....w
w......w0w..w
wwwwwwwwwwwww