wwwwwwwwwwwww
w0...0......w
w.....1..0..w
w...1.0..1..w
w..1.1..1...w
w........1..w
w.1.011.1...w
w..........Aw
wwwwwwwwwwwww