wwwwwwwwwwwww
w..........0w
w...w0w.....w
w..1.1..w...w
w.......w...w
w..wwwwww...w
w.1w........w
w..w..A..0..w
wwwwwwwwwwwww