wwwwwwwwwwwww
w...........w
w..w.w0w.w..w
w..1.....1..w
w..w0w0w0w..w
w..1.....1..w
w..w.wAw.w..w
w...........w
wwwwwwwwwwwww