wwwwwwwwwwwww
w0.........0w
w...........w
w0.........0w
wwwwww..wwwww
w.1.........w
w..11..1....w
w..........Aw
wwwwwwwwwwwww