wwwwwwwwwwwww
w...........w
w.0..1....k.w
w...101.....w
w....w......w
w..0wgw0....w
w.1000001...w
w..00000....w
w....A....0.w
wwwwwwwwwwwww