wwwwwwwwwwwww
wA..........w
wg..1....1..w
wwwwww....1.w
w.....1.....w
w.........m.w
w0w0wwwwwwwww
w...0......kw
wwwwwwwwwwwww