wwwwwwwwwwwww
w..........kw
w11..1....mmw
w..w...1....w
w.....w.....w
w0..........w
w000...w....w
w000.....1..w
wg000......Aw
wwwwwwwwwwwww