wwwwwwwwwwwwwwwwwwwwwwwwwwwww
w..6t.ttt.....c.............w
w...t.....t.tt..t......t....w
w.t.t.....t..ttt......t.....w
w.t.t.t...t...........t3....w
w.t.t.t...t.ttt...t...t.....w
w.t.t.t...t...t...t...ttt...w
w.t...t..5t..4t...t.........w
w.t...t.ttt.ttt..1t.........w
w.t...t...t.t..tttt.....ttt.w
w.t...t.....t..........t....w
w.....t.....t..tttttt..t.A..w
w..c........t......2t..t....w
wwwwwwwwwwwwwwwwwwwwwwwwwwwww
