wwwwwwwwwwwwwwwwwwwwwwwwwwwww
w..c........................w
w...........................w
w...............2...........w
w.......3..............5....w
w...........................w
w...........................w
w.................c.........w
w...1.......................w
w.........c.................w
w............6........4..A..w
w...........................w
w...........................w
wwwwwwwwwwwwwwwwwwwwwwwwwwwww
