wwwwwwwwwwwwwwwwwwwwwwwwwwwww
w.........6.................w
w.ttt....ttt...c.tt...1.....w
w....tt............t........w
w.....t.............t......cw
w....ct...t........ttttt....w
w...t.t...t..A.....t...tt...w
wt..ttt...t........t.2......w
wt........t........t........w
wt.....t..tttttt......tttt..w
wtt....t5............tt...t.w
w4tt...t.....c.......t...3..w
w...........................w
wwwwwwwwwwwwwwwwwwwwwwwwwwwww
