wwwwwwwwwwwwwwwwwwwwwwwwww
w.oo.....ooo..o......A...w
w.x..wow......-...oo...www
w.x..wxw......-........oow
w.x..w.w-.-...-.wwwwww.xxw
w.x..w.w...oo.-........xxw
w.......xx.xx.-....oww...w
w.ooo..www....-....x.....w
w.xxx..-......ww...x-.-..w
w..w...--..........x.....w
w..w.....wwwoo...........w
w....xx.....xx......e....w
wwwwwwwwwwwwwwwwwwwwwwwwww
