wwwwwwwwwwwwwwwwwwwwwwwwww
w........................w
w.xx...x........x.x...xx.w
w.xx...x..............xx.w
w.xx.....................w
w..........e.A...x.......w
w....b............x......w
w........................w
w.....xx.................w
w.....xx.....c.......xx..w
w...................x....w
w........................w
wwwwwwwwwwwwwwwwwwwwwwwwww
