wwwwwwwwwwwwwwwwwwwwwwwwww
w........................w
w.oo.e.xx..--x.....--.ox.w
w.oo...xx..--......--.ox.w
w................x.-b-...w
w....----..........--....w
w....-c--.....oo.........w
w.....-...x...oo.........w
w.xxx.........oo....xxx..w
w.xxx.........oo....xAx..w
w.......oo..........xxx..w
wb.......................w
wwwwwwwwwwwwwwwwwwwwwwwwww
