wwwwwwwwwwwwwwwwwwwwwwwwww
wb......................cw
w.xx..................xx.w
w.xx...w....ww...w....xx.w
w.xx...w.........w....xx.w
w......w...e.A...w.......w
w......w.........w.......w
w......w.........w.......w
w..........ww............w
w.xxx...............xxx..w
w.xxx...............xx...w
wc......................bw
wwwwwwwwwwwwwwwwwwwwwwwwww
