wwwwwwwwwwwwwwwwwwwwwwwwww
w.....w...........-......w
w.oo.ewxx..--..xx-c--.ox.w
w.oo..wxx..--.....---.ox.w
w..................--....w
w....----..........--....w
w....----.x...xx.........w
w.............xx...w.....w
w.xxx..wwwww..xx...w.....w
w.xxx..............w.A...w
w.......oo.........w.....w
w.............b........xxw
wwwwwwwwwwwwwwwwwwwwwwwwww
